START_POS,0 0 0,,,,,,,,
GRID_SIZE_Y,15,,,,,,,,
NUM_GRID,10 10,,,,,,,,
STARTSETSTAGE,,,,,,,,,
1,0,0,1,1,0,0,0,0,0
1,1,0,0,1,0,0,1,1,0
1,0,0,0,0,0,1,0,0,0
1,1,0,0,0,0,1,0,0,1
0,1,1,1,0,1,1,1,0,1
1,1,0,0,0,0,1,0,0,1
1,0,0,0,0,0,1,0,0,1
0,1,0,0,0,0,1,0,0,0
1,1,0,1,1,0,0,0,1,0
1,1,0,1,1,0,0,0,1,0
ENDSETSTAGE,,,,,,,,,
