START_POS,0 0 0,,,,,,,,,,,,,,,,,,,,,,
NUM_GRID,23 16,,,,,,,,,,,,,,,,,,,,,,
STARTSETSTAGE,,,,,,,,,,,,,,,,,,,,,,,
1,1,1,1,1,0,1,1,1,1,1,0,1,1,1,1,1,0,1,1,1,1,1,
1,0,0,2,1,0,0,0,0,0,0,0,0,0,0,0,0,0,1,2,0,0,1,
1,0,0,7,1,0,1,1,1,1,1,0,1,1,1,1,1,0,1,0,0,0,1,
1,0,1,1,1,0,1,0,0,0,0,7,0,0,0,0,1,0,1,1,1,0,1,
1,0,1,0,1,0,1,0,1,1,1,0,1,1,1,0,1,0,1,0,1,0,1,
1,0,1,0,1,0,1,0,1,0,0,0,0,0,1,0,1,0,1,0,1,0,1,
1,0,1,0,1,0,1,0,1,0,3,3,3,0,1,0,1,0,1,0,1,0,1,
0,0,0,0,0,0,0,0,0,0,3,4,3,0,0,0,0,0,0,0,0,0,0,
1,0,1,0,1,0,1,0,1,0,3,3,3,0,1,0,1,0,1,0,1,0,1,
1,0,1,0,1,0,1,0,1,0,0,0,0,0,1,0,1,0,1,0,1,0,1,
1,0,1,0,1,0,1,0,1,1,1,0,1,1,1,0,1,0,1,0,1,0,1,
1,0,1,1,1,0,1,0,0,0,0,7,0,0,0,0,1,0,1,1,1,0,1,
1,0,0,0,1,0,1,1,1,1,1,0,1,1,1,1,1,0,1,0,0,0,1,
1,0,0,2,1,0,0,0,0,6,0,0,0,6,0,0,0,0,1,7,0,0,1,
1,1,1,1,1,0,1,1,1,1,1,0,1,1,1,1,1,0,1,1,1,1,1,
1,0,0,0,0,0,1,0,0,0,0,0,0,0,0,0,1,0,0,0,0,0,1,
ENDSETSTAGE,,,,,,,,,,,,,,,,,,,,,,,
