START_POS,0 0 0,,,,,,,,,,,,,,,,,,,,,,
NUM_GRID,23 15,,,,,,,,,,,,,,,,,,,,,,
STARTSETSTAGE,,,,,,,,,,,,,,,,,,,,,,,
1,1,0,1,1,0,1,0,1,0,1,1,1,0,1,0,1,0,1,1,0,1,1,
0,0,8,11,1,2,0,0,0,0,0,10,0,0,0,0,0,0,1,11,7,0,0,
1,0,1,11,0,0,1,1,0,1,1,1,1,1,0,1,1,0,0,11,1,0,1,
0,0,0,11,1,1,0,0,0,0,0,9,0,0,0,0,0,1,1,11,0,0,0,
1,1,1,11,1,0,0,1,0,1,1,0,1,1,0,1,0,0,1,11,1,1,1,
1,0,0,11,0,0,1,11,0,0,0,0,0,0,0,11,1,0,0,11,0,0,1,
0,0,1,11,1,0,1,11,1,0,3,3,3,0,1,11,1,0,1,11,1,0,0,
1,1,1,5,1,2,0,5,0,0,3,4,3,0,0,5,0,2,1,5,1,1,1,
0,0,1,11,1,0,1,11,1,0,3,3,3,0,1,11,1,0,1,11,1,0,0,
1,0,0,11,0,0,1,11,0,6,0,0,0,6,0,11,1,0,0,11,0,0,1,
1,1,1,11,1,0,0,1,0,1,1,0,1,1,0,1,0,0,1,11,1,1,1,
0,0,0,11,1,1,0,0,0,0,0,7,0,0,0,0,0,1,1,11,0,0,0,
1,0,1,11,0,0,1,1,0,1,1,1,1,1,0,1,1,0,0,11,1,0,1,
0,0,7,11,1,0,0,0,0,0,0,10,0,0,0,0,0,2,1,11,8,0,0,
1,1,0,1,1,0,1,0,1,0,1,1,1,0,1,0,1,0,1,1,0,1,1,
ENDSETSTAGE,,,,,,,,,,,,,,,,,,,,,,,
,,,,,,,,,,,,,,,,,,,,,,,
